#########################
#A  #       #     #     #
# # # ##### # ### # ### #
# #   #   #   #   #   # #
# ### ### ##### ### ### #
#     #   #     #   #   #
### # # ##### # # ### ###
#   # #     # # #   #   #
# ### ### # ### ### ### #
#   #   # #     #   #   #
# ##### # ##### ### # ###
#     #     #     #     #
##### ### ### ### ### ###
#   #   #   #   #   #   #
# ### ### # #B# ### ### #
#     #   #     #     # #
### ### ##### ### ##### #
#     #     #     #     #
# ### ##### ### ### ### #
#     #     #     #   # #
#########################
